BBBBBBBBBBBBBBBBBBBB
BBB1FFBBBBFFFFFF2BBB
BFFFBFBBBFBBBFBFFFBB
BBFFFFFFFBFFBBBBFFFB
BFFFBBFBBFFFFFFFBFFB
BFBBFBBFFBBFFFBFBFBB
BFBFFFFFFBFBFFFFBFFB
BFBFFBFBFFBFFFFFFBFB
BFFBFFFBFBBFFFFBBFFB
BFFFBFBFFFGFFFBFFBFB
BFBFFFFBBBFBFBFFFFFB
BFBBFFFFFBFBFFFFFBFB
BFFFBFBFBFFFBFBFFFBB
BFBBBFFFBFFFBBBFFFBB
BFBFBBFFBFFBBFBBFFFB
BFBBFFFFFBFFFBBFBBBB
BFFBBFBFBFFBBFFFFFFB
BBFBFFBFFFFFBFFBFBBB
BB4FFFFFBBBFFFFFFF3B
BBBBBBBBBBBBBBBBBBBB
