BBBBBBBBBBBBBBBBBBBB
B1FFFFFFFFFFFFFFFB4B
BBFFFFFBBBBBBFFFFBFB
BFFBBBBBFFFFBFFBBBFB
BFFFFBBBFBBBBFFFBFFB
BBBFBBFFFBBFFFFBBFFB
BFFBBFFBFFFFBBFFBBFB
BBFBFFFFBBBFFBBFFFFB
BFBBFFFFFBGFBBFFFFFB
BFFFFFFBBFFFFFBBBBBB
BFFFFBBFFBBBBBBFFFFB
BBFBBFFFFFBBFFFFBBBB
BBFFFFBBFFFFBBFFBBFB
BFFBBBFFFFFBFFFFFBFB
BFBFBBFFFFFFFBBFFFFB
BFBBFFBFFFFFBBFBBBBB
BFFFFFBBFFFFBBFFFFFB
BFBFBFBFBBFFFFFFBBFB
B2FFFFFFBBFFFFFFF3BB
BBBBBBBBBBBBBBBBBBBB