BBBBBBBBBBBBBBBBBBBB
B1F2FFFFFFFFFFFFFFFB
BFFFFFFFFFFFFFFFFFFB
BFFFFFFFFFFFFFFFGIIB
BFFFFFFFFFFFFFFFFIIB
BFFHHHHHHHHFFFFFFFFB
BFFHHHHHHHHFFFFFFFFB
BFFFGFFFFFFFFFHHFFHB
BFFFFFFFFFFFFFHHFFHB
BFFHHHHHHHHFFFHHFFHB
BFFHHHHHHHHFFFHHFFHB
BFFFFFFFFFFFFFFFFFHB
BFFFGFFFFFFFFFFF3FFB
BFFHHHHHHHHHFFFF4FFB
BFFHHHHHHHHHFFFFFFFB
BFFFFFFFFFFFFFFFFFFB
BFFFFFFFFFFFFFFFFFFB
BFFHHHHHHHHHFFGOOFFB
BFFFFFFFFFFFFFFOOFFB
BBBBBBBBBBBBBBBBBBBB