BBBBBBBBBBBBBBBBBBBBBBBBBBBBBBBBBBBBBBBBB
BFFFFFFFFFFFFFFFFFFFFFFFFFFFFFFFFFFFFFFFB
BFFFFFFFFFFFFFFFFFFFFFFFFFFFFFFFFFFFFFFFB
BFFHHHHHHHHHHHHHHHHFFFFFFFFFFFFFFFFFFFFFB
BFFFFFFFFFFFFFFFFFFFFFFFFFFFFFFFFFFFFFFFB
BFFFFFFFFFFFFFFFFFFFFFFFFFFFFFFFFFFFFFOOB
BFFFFFFFFFFFFFFFFFFFFFFFFFHFFFHFFFHFFFOOB
BFFFFFFFFFFFFFFFFFFFFFFFFFHFFFHFFFHFFFFFB
BFFHHHHHHHHHHHHHHHHFFFFFFFHFFFHFFFHFFFFFB
BFFHHHHHHHHHHHHHHHHFFFFFFFHFFFHFFFHFFFFFB
BFFFFFFFFFFFFFFFFFFFFFFFFFHFFFHFFFHFFFFFB
BFFFFFFFFFFFFFFFFFFFFFFFFFHFFFHFFFHFFFFFB
BFFFFFFFFFFFFFFFFFFFFFFFFFHFFFHFFFHFFFFFB
BFFFFFFFFFFFFFFFFFFFFFFFFFHFFFHFFFHFFFFFB
BFFHHHHHHHHHHHHHHHHFFFFFFFFFFFFFFFFFFFFFB
BFFFFFFFFFFFFFFFFFFFFFFFFFFFFFFFFFFFFFFFB
BFFFFFFFFFFFFFFFFFFFFFFFFFFFFFFFFFFFFFFFB
BFFFFFFFFFFFFFFFFFFFFFFFFFFFFFFFFFFFFFFFB
BFFFFFBFFFFFFFFBBFFFFFFFBBFFFFFFFFBFFFFFB
BFFFFFBFFFFFFFFBBFFFFFFFBBFFFFFFFFBFFFFFB
BFFFFFFFFFFFFFFFFFFFFFFFFFFFFFFFFFFFFFFFB
BFFFFFFFFFFFFFFFFFFFFFFFFFFFFFFFFFFFFFFFB
BFFFFFFFFFFFFFFFFFFFFFFFFFFFFFFFFFFFFFFFB
BFFHHHHHHHHHHHHHHHHFFFFFFFFFFFFFFFFFFFFFB
BFFFFFFFFFFFFFFFFFFFFFFFFFFFFFFFFFFFFFFFB
BFFFFFFFFFFFFFFFFFFFFFFFFFHHFFFFHFFFFFFFB
BFFFFFFFFFFFFFFFFFFFFFFFFFHHFFFFHFFFFFFFB
BFFFFFFFFFFFFFFFFFFFFFFFFFHHFFFFHFFFFFFFB
BFFHHHHHHHHHHHHHHHHFFFFFFFHHFFFFHFFFFFFFB
BFFHHHHHHHHHHHHHHHHFFFFFFFHHFFFFHFFFFFFFB
BFFFFFFFFFFFFFFFFFFFFFFFFFHHFFFFHFFFFFFFB
BFFFFFFFFFFFFFFFFFFFFFFFFFHHFFFFHFFFFFFFB
BFFFFFFFFFFFFFFFFFFFFFFFFFHHFFFFHFFFFFFFB
BFFFFFFFFFFFFFFFFFFFFFFFFFFFFFFFFFFFFFFFB
BFFHHHHHHHHHHHHHHHHFFFFFFFFFFFFFFFFFFFFFB
BFFHHHHHHHHHHHHHHHHFFFFFFFFFFFFFFFFFFFFFB
BFFFFFFFFFFFFFFFFFFFFFFFFFFFFFFFFFFFFFFFB
BFFFFFFFFFFFFFFFFFFFFFFFFFFFFFFFFFFFFFFFB
BFFFFFFFFFFFFFFFFFFFFFFFFFFFFFFFFFFFIIFFB
BFFFFFFFFFFFFFFFFFFF5FF4FF3FF2FF1FFFIIFFB
BBBBBBBBBBBBBBBBBBBBBBBBBBBBBBBBBBBBBBBBB