BBBBBBBBBBBBBBBBBBBBBBBBBBBBBBBBBBBBBBBBB
BFFFFFFFFFFFFFFFFFFFFFFFFFFFFFFFFFFFFFFFB
BFFFFFFFFFFFFFFFFFFFFFFFFFFFFFFFFFFFFFFFB
BFFHHHHHHHHHHHHHHHHFFFFFFFFFFFFFFFFFFFFFB
BFFFFFFFFFFFFFFFFFFFFFFFFFFFFFFFFFFFFFFFB
BFFFFFFFFFFFFFFFFFFFFFFFFFFFFFFFFFFFFFOOB
BFFFFFFFFFFFFFFFFFFFFFFFFFHFFFHFFFHFFFOOB
BFFFFFFFFFFFFFFFFFFFFFFFFFHFFFHFFFHFFFGGB
BFFHHHHHHHHHHHHHHHHFFFFFFFHFFFHFFFHFFFFFB
BFFHHHHHHHHHHHHHHHHFFFFFFFHFFFHFFFHFFFFFB
BFFFFFFFFFFFFFFFFFFFFFFFFFHFFFHFFFHFFFFFB
BFFFFFFFFFFFFFFFFFFFFFFFFFHFFFHFFFHFFFFFB
BFFFFFFFFFFFFFFFFFFFFFFFFFHFFFHFFFHFFFFFB
BFFFFFFFFFFFFFFFFFFFFFFFFFHFFFHFFFHFFFFFB
BFFHHHHHHHHHHHHHHHHFFFFFFFFFFFFFFFFFFFFFB
BFFFFFFFFGFFFFFFFFFFFFFFFFFFFFFFFFFFFFFFB
BFFFFFFFFFFFFFFFFFFFFFFFFFFFFFFFFFFFFFFFB
BFFFFFFFFFFFFFFFFFFFFFFFFFFFFFFFFFFFFFFFB
BFFFFFBFFFFFFFFBBFFFFFFFBBFFFFFFFFBFFFFFB
BFFFFFBFFFFFFFFBBFFFFFFFBBFFFFFFFFBFFFFFB
BFFFFFFFFFFFFFFFFFFFFFFFFFFFFFFFFFFFFFFFB
BFFFFFFFFFFFFFFFFFFFFFFFFFFFFFFFFFFFFFFFB
BFFFFFFFFFFFFFFFFFFFFFFFFFFFFFFFFFFFFFFFB
BFFHHHHHHHHHHHHHHHHFFFFFFFFFFFFFFFFFFFFFB
BFFFFFFFFFFFFFFFFFFFFFFFFFFFFFFFFFFFFFFFB
BFFFFFFFFFFFFFFFFFFFFFFFFFHHFFFFHFFFFFFFB
BFFFFFFFFFFFFFFFFFFFFFFFFFHHFFFFHFFFFFFFB
BFFFFFFFFFFGFFFFFFFFFFFFFFHHFFFFHFFFFFFFB
BFFHHHHHHHHHHHHHHHHFFFFFFFHHFFFFHFFFFFFFB
BFFHHHHHHHHHHHHHHHHFFFFFFGHHFFFFHFFFFFFFB
BFFFFFFFFGFFFFFFFFFFFFFFFFHHFFFFHFFFFFFFB
BFFFFFFFFFFFFFFFFFFFFFFFFFHHFFFFHFFFFFFFB
BFFFFFFFFFFFFFFFFFFFFFFFFFHHFFFFHFFFFFFFB
BFFFFFFFGFFFFFFFFFFFFFFFFFFFFFFFFFFFFFFFB
BFFHHHHHHHHHHHHHHHHFFFFFFFFFFFFFFFFFFFFFB
BFFHHHHHHHHHHHHHHHHFFFFFFFFFFFFFFFFFFFFFB
BFFFFFFFFFFFFFFFFFFFFFFFFFFFFFFFFFFFFFFFB
BFFFFFFFFFFFFFFFFFFFFFFFFFFFFFFFFFFFFFFFB
BFFFFFFFFFFFFFFFFFFFFFFFFFFFFFFFFFFGIIFFB
BFFFFFFFFFFFFFFFFFFFFFFFFF3FF2FF1FFGIIGFB
BBBBBBBBBBBBBBBBBBBBBBBBBBBBBBBBBBBBBBBBB