BBBBBBBBBBBBBBBBBBBBBBBBBBBBBBBBBBBBBBBBB
BFFFFFFFFFFFFFFFFFFFFFFFFFFFFFFFFFFFFFFFB
BFFFFFGFFFFFFFFFFFFFFFFFFFFFFFFFFFFFFFFFB
BFFHHHHHHHHHHHHHHHHFFFFFFFFFFFFFFFFFFFFFB
BFFFFFFFFFFFFFFFFFFFFFFFFFFFFFFFFFFFFFGFB
BFFFFFFFFFFFFFFFFFFFFFFFFFFFFFFFFFFFFFOOB
BFFFFFFFFFFFFFFFFFFFFFFFFFHFFFHFFFHFFGOOB
BFFFFFFFFFFFFFFFFFFFFFFFFFHFFFHFFFHFFFGGB
BFFHHHHHHHHHHHHHHHHFFFFFFFHFFFHFFFHFFFFFB
BFFHHHHHHHHHHHHHHHHFFFFFFFHFFFHFFFHFFFFFB
BFFFFFFFGFFFFFFFFFFFFFFFFFHFFFHFFFHFFFFFB
BFFFFFFFFFFFFFFFFFFFFFFFFFHFFFHFFFHFFFFFB
BFFFFFFFFFFFFFFFFFFFFFFFFFHFFFHFFFHFFFFFB
BFFFFFFFFFFFFFFFFFFFFFFFFFHFFFHFFFHFFFFFB
BFFHHHHHHHHHHHHHHHHFFFFFFFFFFFFFFFFFFFFFB
BFFFFFFFFGFFFFFFFFFFFFFFFFFFFFFFFFFFFFFFB
BFFFFFFFFFFFFFFFFFFFFFFFFFFFFFFFFFFFFFFFB
BFFFFFFFFFFFFFFFFFFFFFFFFFFFFFFFFFFFFFFFB
BFFFFFBFFFFFFFFBBFFFFFFFBBFFFFFFFFBFFFFFB
BFFFFFBFFFFFFFFBBFFFFFFFBBFFFFFFFFBFFFFFB
BFFFFFFFFFFFFFFFFFFFFFFFFFFFFFFFFFFFFFFFB
BFFFFFFFFFFFFFFFFFFFFFFFFFFFFFFFFFFFFFFFB
BFFFFFFFFFFFFFFFFFFFFFFFFFFFFFFFFFFFFFFFB
BFFHHHHHHHHHHHHHHHHFFFFFFFFFFFFFFFFFFFFFB
BFFFFFFFFFFFFFFFFFFFFFFFFFFFFFFFFFFFFFFFB
BFFFFFFFFFFFFFFFFFFFFFFFFFHHFFFFHFFFFFFFB
BFFFFFFFFFFFFFFFFFFFFFFFFFHHFFFFHFFFFFFFB
BFFFFFFFFFFGFFFFFFFFFFFFFFHHFFFFHFFFFFFFB
BFFHHHHHHHHHHHHHHHHFFFFFFFHHFFFFHFFFFFFFB
BFFHHHHHHHHHHHHHHHHFFFFFFGHHFFFFHFFFFFFFB
BFFFFFFFFGFFFFFFFFFFFFFFFFHHFFFFHFFFFFFFB
BFFFFFFFFFFFFFFFFFFFFFFFFFHHFFFFHFFFFFFFB
BFFFFFFFFFFFFFFFFFFFFFFFFFHHFFFFHFFFFFFFB
BFGFFFFFGFFFFFFFFFFFFFFFFFFFFFFFFFFFFFFFB
BFFHHHHHHHHHHHHHHHHFFFFFFFFFFFFFFFFFFFFFB
BFFHHHHHHHHHHHHHHHHFFFFFFFFFFFFFFFFFFFFFB
BFFFFFFFFFFFFFFFFFFFFFFFFFFFFFFFFFFFFFFFB
BFFFFFFFFFFFFFFFFFFFFFFFFFFFFFFFFFFFFFFFB
BFFFFFFFFFFFFFFFFFFFFFFFFFFFFFFFFFFGIIFFB
BFFFFFFFFFFFFFFFFFFFFFF4FF3FF2FF1FFGIIGFB
BBBBBBBBBBBBBBBBBBBBBBBBBBBBBBBBBBBBBBBBB