BBBBBBBBBBBBBBBBBBBB
BBFBFFFBFBFFFFFF12BB
BFBFFBBBBFFFFFFFFF3B
BFFBFFFFBFBBBBFBBF4B
BBFFFBFBFBFFFFFFBFBB
BFFFFFFFFBBFFBBBFFFB
BFFFFBFBFBFBFBBFFBFB
BBFFBFFBBFBFFFBBFBBB
BFBFFBFFFFFFBBBFBFBB
BFFFFFFFBBBFFBFFFBFB
BBBFBBFBBBFBFBFFBBFB
BFBFBFFFFFFBBFFFFBBB
BBBFBFBBFFBBFFFFFFFB
BBFFFFBBBBBFFBBFBFFB
BFFBFBFFFFBFFFFFBBBB
BBFBFBBBBFBFFFFFFFFB
BFFBBFFBFBFFFFBFFFBB
BBFBBBFBFFFFFBFBFBFB
BGFBFBFBFFFBFBBBBFFB
BBBBBBBBBBBBBBBBBBBB
