BBBBBBBBBBBBBBBBBBBB
BGFFBBFFFFFFFFFFFFGB
BFFFFFBFFBFBFBBFFBBB
BFFFFFBFFFFFFBBBFFFB
BFFFBFBFFFFFFFFBBBFB
BFBBBFFBFBBFBFFFFFFB
BBFBFFBBFBBFFFFBBBFB
BBFFBFBFFBBBBBFFFFFB
BFFFBFFBFFFFFBFBFFFB
BFBFFFBBFBFFBBFFFFFB
BFFBFBFFFBBFFBBFBFFB
BBBBFBFFBFBFFFBFFFFB
BFFFFBBBBFBFBBBFBBFB
BFFFBBBBBFBFBFBBBBFB
BFBFBFFBFFBFFFBBBFFB
BFBFFFFBFBFBFBFBFBBB
BBFFFFFFFBBBFFFFFBBB
BFFBFFFBBBBFFBBBFFFB
B1BFBFFFBFBFBFBBBF2B
BBBBBBBBBBBBBBBBBBBB
