BBBBBBBBBBBBBBBBBBBB
B3FFFFFF4FFFFFFFFFFB
BFBBBBBBBBBBBBFBBBFB
BFBFFFFFFFFFFFFFFBFB
BFBFBBFBBBBBBBBBFBFB
BFBFBFFFFFFFFFFBFBFB
BFBFBFBBBBBBBBFBFBFB
BFBFBFBFFFFFFBFBFBFB
BFBFBFBFBBBBFBFBFB2B
BFBFBFBFBFFBFBFBFBFB
BFFFBFBFBGFBFBFBFBFB
BFBFBFBFBBFBFBFBFBFB
BFBFBFBFFFFBFBFBFBFB
BFBFBFBBBBBBFBFBFBFB
BFBFBFFFFFFFFFFBFBFB
BFBFBBBBBBBBBBBBFFFB
BFBFFFFFFFFFFFFFFBFB
BFBBBBBBBBFBBBBBBBFB
BF1FFFFFFFFFFFFFFFFB
BBBBBBBBBBBBBBBBBBBB
