BBBBBBBBBBBBBBBBBBBB
B1FF2FF3FF4FF5FFFFFB
BFFFFFFFFFFFFFFFFFFB
BFFFFFFFFFFFFFFFGIIB
BFFFFFFFFFFFFFFFFIIB
BFFHHHHHHHHFFFFFFFFB
BFFHHHHHHHHFFFFFFFFB
BFFFFGFFFFFFFFHHFFHB
BFFFFFFFFFFFFFHHFFHB
BFFHHHHHHHHFFFHHFFHB
BFFHHHHHHHHFFFHHFFHB
BFFFFFFFFFFFFFFFFFHB
BFFFFFFFFFFFFFFFFFFB
BFFHHHHHHHHHFFFFFFFB
BFFHHHHHHHHHFFFFFFFB
BFFFFFFFFFFFFFFFFFFB
BFFFFFFFFFFFFFFFFFFB
BFFHHHHHHHHHFFFOOFFB
BFFFFFFFFFFFFFFOOFFB
BBBBBBBBBBBBBBBBBBBB