BBBBBBBBBBBBBBBBBBBBBB
B1FFFFFFFFFFFFFFFFFBBB
BFFFFFFFFFFFFFFFFFFBBB
BFFFFFFFFFFFFFFFGIIBBB
BFFFFFFFFFFFFFFFFIIBBB
BFFHHHHHHHHFFFFFFFFBBB
BFFHHHHHHHHFFFFFFFFBBB
BFFFFGFFFFFFFFHHFFHBBB
BFFFFFFFFFFFFFHHFFHBBB
BFFHHHHHHHHFFFHHFFHBBB
BFFHHHHHHHHFFFHHFFHBBB
BFFFFFFFFFFFFFFFFFHBBB
BFFFFFFFFFFFFFFFFFFBBB
BFFHHHHHHHHHFFFFFFFBBB
BFFHHHHHHHHHFFFFFFFBBB
BFFFFFFFFFFFFFFFFFFBBB
BFFFFFFFFFFFFFFFFFFBBB
BFFHHHHHHHHHFFFOOFFBBB
BFFFFFFFFFFFFFFOOFFBBB
BBBBBBBBBBBBBBBBBBBBBB