BBBBBBBBBBBBBBBBBBBBBBBBBBBBBBBBBBBBBBBBB
BFFFFFFFFFFFFFFFFFFFFFFFFFFFFFFFFFFFFFFFB
BFFFFFFFFFFGFFFFFFFFFFFFFFFFFFFFFFFFFFFFB
BFFHHHHHHHHHHHHHHHHFFFFFFFFFFFFFFFFFFFFFB
BFFFFFFFFFFFFFFFFFFFFFFFFFFFFFFFFFFFFFGFB
BFFFFFFFFFFFFFFFFFFFFFFFFFFFFFFFFFFFFFOOB
BFFFFFFFFFFFFFFFFFFFFFFFFFHFFFHFFFHFFGOOB
BFFFFFFFFFFFFFFGFFFFFFFFFFHFFFHFFFHFFFGGB
BFFHHHHHHHHHHHHHHHHFFFFFFFHFFFHFFFHFFFFFB
BFFHHHHHHHHHHHHHHHHFFFFFFFHFFFHFFFHFFFFFB
BFFFFFFFFGFFFFFFFFFFFFFFFFHFFFHFFFHFFFFFB
BFFFFFFFFFFFFFFFFFFFFFFFFFHFFFHFFFHFFFFFB
BFFFFFFFFFFFFFFFFFFFFFFFFFHFFFHFFFHFFFFFB
BFFFFFFFFFFFFFFFFFFFFFFFFFHFFFHFFFHFFFFFB
BFFHHHHHHHHHHHHHHHHFFFFFFFFFFFFFFFFFFFFFB
BFFFFFFFFGFFFFFFFFFFFFFFFFFFFFFFFFFFFFFFB
BFFFFFFFFFFFFFFFFFFFFFFFFFFFFFFFFFFFFFFFB
BFFFFFFFFFFFFFFFFFFFFFFFFFFFFFFFFFFFFFFFB
BFFFFFBFFFFFFFFBBFFFFFFFBBFFFFFFFFBFFFFFB
BFFFFFBFFFFFFFFBBFFFFFFFBBFFFFFFFFBFFFFFB
BFFFFFFFFFFFFFFFFFFFFFFFFFFFFFFFFFFFFFFFB
BFFFFFFFFFFFFFFFFFFFFFFFFFFFFFFFFFFFFFFFB
BFFFFFFFFGFFFFFFFFFFFFFFFFFFFFFFFFFFFFFFB
BFFHHHHHHHHHHHHHHHHFFFFFFFFFFFFFFFFFFFFFB
BFFFFFFFFFFFFFFFFFFFFFFFFFFFFFFFFFFFFFFFB
BFFFFFFFFFFFFFFFFFFFFFFFFFHHFFFFHFFFFFFFB
BFFFFFFFFFFFFFFFFFFFFFFFFFHHFFFFHFFFFFFFB
BFFFFFFFFFFGFFFFFFFFFFFFFFHHFFFFHGFFFFFFB
BFFHHHHHHHHHHHHHHHHFFFFFFFHHFFFFHFFFFFFFB
BFFHHHHHHHHHHHHHHHHFFFFFFGHHFFFFHFFFFFFFB
BFFFFFFFFGFFFFFFFFFFFFFFFFHHFFFFHFFFFFFFB
BFFFFFFFFFFFFFFFFFFFFFFFFFHHFFFFHFFFFFFFB
BFGFFFFFFFFFFFFFFFFFFFFFFFHHFFFFHFFFFFFFB
BFFFFFFFGFFFFFFFFFFFFFFFFFFFFFFFFFFFFFFFB
BFFHHHHHHHHHHHHHHHHFFFFFFFFFFFFFFFFFFFFFB
BFFHHHHHHHHHHHHHHHHFFFFFFFFFFFFFFFFFFFFFB
BGFFFFFFFFFFFFFFFFFFFFFFFFFFFFFFFFFFFFFFB
BFFFFFFFFFFFFFFFFFFFFFFFFFFFFFFFFFFFGGFFB
BFFFFFFFFFFFFFFFFFFFFFFFFFFFFFFFFFFFIIGFB
BFFFFFFFFFFFFFFFFFFF5FF4FF3FF2FF1FFGIIFFB
BBBBBBBBBBBBBBBBBBBBBBBBBBBBBBBBBBBBBBBBB